#Package	Display name
Human.1.0	Human; version 1.0
MIGS.ba.4.0	MIGS: cultured bacteria/archaea; version 4.0
MIGS.ba.air.4.0	MIGS: cultured bacteria/archaea, air; version 4.0
MIGS.ba.built.4.0	MIGS: cultured bacteria/archaea, built; version 4.0
MIGS.ba.host-associated.4.0	MIGS: cultured bacteria/archaea, host-associated; version 4.0
MIGS.ba.human-associated.4.0	MIGS: cultured bacteria/archaea, human-associated; version 4.0
MIGS.ba.human-gut.4.0	MIGS: cultured bacteria/archaea, human-gut; version 4.0
MIGS.ba.human-oral.4.0	MIGS: cultured bacteria/archaea, human-oral; version 4.0
MIGS.ba.human-skin.4.0	MIGS: cultured bacteria/archaea, human-skin; version 4.0
MIGS.ba.human-vaginal.4.0	MIGS: cultured bacteria/archaea, human-vaginal; version 4.0
MIGS.ba.microbial.4.0	MIGS: cultured bacteria/archaea, microbial; version 4.0
MIGS.ba.miscellaneous.4.0	MIGS: cultured bacteria/archaea, miscellaneous; version 4.0
MIGS.ba.plant-associated.4.0	MIGS: cultured bacteria/archaea, plant-associated; version 4.0
MIGS.ba.sediment.4.0	MIGS: cultured bacteria/archaea, sediment; version 4.0
MIGS.ba.soil.4.0	MIGS: cultured bacteria/archaea, soil; version 4.0
MIGS.ba.wastewater.4.0	MIGS: cultured bacteria/archaea, wastewater; version 4.0
MIGS.ba.water.4.0	MIGS: cultured bacteria/archaea, water; version 4.0
MIGS.eu.4.0	MIGS: eukaryote; version 4.0
MIGS.eu.air.4.0	MIGS: eukaryote, air; version 4.0
MIGS.eu.built.4.0	MIGS: eukaryote, built; version 4.0
MIGS.eu.host-associated.4.0	MIGS: eukaryote, host-associated; version 4.0
MIGS.eu.human-associated.4.0	MIGS: eukaryote, human-associated; version 4.0
MIGS.eu.human-gut.4.0	MIGS: eukaryote, human-gut; version 4.0
MIGS.eu.human-oral.4.0	MIGS: eukaryote, human-oral; version 4.0
MIGS.eu.human-skin.4.0	MIGS: eukaryote, human-skin; version 4.0
MIGS.eu.human-vaginal.4.0	MIGS: eukaryote, human-vaginal; version 4.0
MIGS.eu.microbial.4.0	MIGS: eukaryote, microbial; version 4.0
MIGS.eu.miscellaneous.4.0	MIGS: eukaryote, miscellaneous; version 4.0
MIGS.eu.plant-associated.4.0	MIGS: eukaryote, plant-associated; version 4.0
MIGS.eu.sediment.4.0	MIGS: eukaryote, sediment; version 4.0
MIGS.eu.soil.4.0	MIGS: eukaryote, soil; version 4.0
MIGS.eu.wastewater.4.0	MIGS: eukaryote, wastewater; version 4.0
MIGS.eu.water.4.0	MIGS: eukaryote, water; version 4.0
MIGS.vi.4.0	MIGS: virus; version 4.0
MIGS.vi.air.4.0	MIGS: virus, air; version 4.0
MIGS.vi.built.4.0	MIGS: virus, built; version 4.0
MIGS.vi.host-associated.4.0	MIGS: virus, host-associated; version 4.0
MIGS.vi.human-associated.4.0	MIGS: virus, human-associated; version 4.0
MIGS.vi.human-gut.4.0	MIGS: virus, human-gut; version 4.0
MIGS.vi.human-oral.4.0	MIGS: virus, human-oral; version 4.0
MIGS.vi.human-skin.4.0	MIGS: virus, human-skin; version 4.0
MIGS.vi.human-vaginal.4.0	MIGS: virus, human-vaginal; version 4.0
MIGS.vi.microbial.4.0	MIGS: virus, microbial; version 4.0
MIGS.vi.miscellaneous.4.0	MIGS: virus, miscellaneous; version 4.0
MIGS.vi.plant-associated.4.0	MIGS: virus, plant-associated; version 4.0
MIGS.vi.sediment.4.0	MIGS: virus, sediment; version 4.0
MIGS.vi.soil.4.0	MIGS: virus, soil; version 4.0
MIGS.vi.wastewater.4.0	MIGS: virus, wastewater; version 4.0
MIGS.vi.water.4.0	MIGS: virus, water; version 4.0
MIMARKS.specimen.4.0	MIMARKS: specimen; version 4.0
MIMARKS.specimen.air.4.0	MIMARKS: specimen, air; version 4.0
MIMARKS.specimen.built.4.0	MIMARKS: specimen, built; version 4.0
MIMARKS.specimen.host-associated.4.0	MIMARKS: specimen, host-associated; version 4.0
MIMARKS.specimen.human-associated.4.0	MIMARKS: specimen, human-associated; version 4.0
MIMARKS.specimen.human-gut.4.0	MIMARKS: specimen, human-gut; version 4.0
MIMARKS.specimen.human-oral.4.0	MIMARKS: specimen, human-oral; version 4.0
MIMARKS.specimen.human-skin.4.0	MIMARKS: specimen, human-skin; version 4.0
MIMARKS.specimen.human-vaginal.4.0	MIMARKS: specimen, human-vaginal; version 4.0
MIMARKS.specimen.microbial.4.0	MIMARKS: specimen, microbial; version 4.0
MIMARKS.specimen.miscellaneous.4.0	MIMARKS: specimen, miscellaneous; version 4.0
MIMARKS.specimen.plant-associated.4.0	MIMARKS: specimen, plant-associated; version 4.0
MIMARKS.specimen.sediment.4.0	MIMARKS: specimen, sediment; version 4.0
MIMARKS.specimen.soil.4.0	MIMARKS: specimen, soil; version 4.0
MIMARKS.specimen.wastewater.4.0	MIMARKS: specimen, wastewater; version 4.0
MIMARKS.specimen.water.4.0	MIMARKS: specimen, water; version 4.0
MIMARKS.survey.air.4.0	MIMARKS: survey, air; version 4.0
MIMARKS.survey.built.4.0	MIMARKS: survey, built; version 4.0
MIMARKS.survey.host-associated.4.0	MIMARKS: survey, host-associated; version 4.0
MIMARKS.survey.human-associated.4.0	MIMARKS: survey, human-associated; version 4.0
MIMARKS.survey.human-gut.4.0	MIMARKS: survey, human-gut; version 4.0
MIMARKS.survey.human-oral.4.0	MIMARKS: survey, human-oral; version 4.0
MIMARKS.survey.human-skin.4.0	MIMARKS: survey, human-skin; version 4.0
MIMARKS.survey.human-vaginal.4.0	MIMARKS: survey, human-vaginal; version 4.0
MIMARKS.survey.microbial.4.0	MIMARKS: survey, microbial; version 4.0
MIMARKS.survey.miscellaneous.4.0	MIMARKS: survey, miscellaneous; version 4.0
MIMARKS.survey.plant-associated.4.0	MIMARKS: survey, plant-associated; version 4.0
MIMARKS.survey.sediment.4.0	MIMARKS: survey, sediment; version 4.0
MIMARKS.survey.soil.4.0	MIMARKS: survey, soil; version 4.0
MIMARKS.survey.wastewater.4.0	MIMARKS: survey, wastewater; version 4.0
MIMARKS.survey.water.4.0	MIMARKS: survey, water; version 4.0
MIMS.me.air.4.0	MIMS: metagenome/environmental, air; version 4.0
MIMS.me.built.4.0	MIMS: metagenome/environmental, built; version 4.0
MIMS.me.host-associated.4.0	MIMS: metagenome/environmental, host-associated; version 4.0
MIMS.me.human-associated.4.0	MIMS: metagenome/environmental, human-associated; version 4.0
MIMS.me.human-gut.4.0	MIMS: metagenome/environmental, human-gut; version 4.0
MIMS.me.human-oral.4.0	MIMS: metagenome/environmental, human-oral; version 4.0
MIMS.me.human-skin.4.0	MIMS: metagenome/environmental, human-skin; version 4.0
MIMS.me.human-vaginal.4.0	MIMS: metagenome/environmental, human-vaginal; version 4.0
MIMS.me.microbial.4.0	MIMS: metagenome/environmental, microbial; version 4.0
MIMS.me.miscellaneous.4.0	MIMS: metagenome/environmental, miscellaneous; version 4.0
MIMS.me.plant-associated.4.0	MIMS: metagenome/environmental, plant-associated; version 4.0
MIMS.me.sediment.4.0	MIMS: metagenome/environmental, sediment; version 4.0
MIMS.me.soil.4.0	MIMS: metagenome/environmental, soil; version 4.0
MIMS.me.wastewater.4.0	MIMS: metagenome/environmental, wastewater; version 4.0
MIMS.me.water.4.0	MIMS: metagenome/environmental, water; version 4.0
Microbe.1.0	Microbe; version 1.0
Model.organism.animal.1.0	Model organism or animal; version 1.0
Pathogen.cl.1.0	Pathogen: clinical or host-associated; version 1.0
Pathogen.env.1.0	Pathogen: environmental/food/other; version 1.0
Plant.1.0	Plant; version 1.0
Virus.1.0	Virus; version 1.0
